0 0 0 0 0 0 0 0 0 0 0 0 0 0 0 0 0 0 0 0 0 0 0 0 0 0 0 0 0 0 0 0 0 0 0 0 0 0 0 0 0 0 0 0 0 0 0 0 0 0 0 0 0 0 0 0 0 0 0 0 0 0 0 0 0 0 0 0 0 0 0 0 0 0 0 0 0 0 0 0 0 0 0 0 0 0 0 0 0 0 0 0 0 0 0 0 0 0 0 0 0 0 0 0 0 0 0 0 0 0 0 0 0 0 0 0 0 0 0 0 0 0 0 0 0 0 0 0 0 0 0 0 0 0 0 0 0 0 0 0 0 0 0 0 0 0 0 0 0 0 0 0 0 0 94 95 95 95 95 95 95 95 95 95 95 95 95 95 95 95 95 95 95 95 95 95 
0 0 0 0 0 0 0 0 0 0 0 0 0 0 0 0 0 0 0 0 0 0 0 0 0 0 0 0 0 0 0 0 0 0 0 0 0 0 0 0 0 0 0 0 0 0 0 0 0 0 0 0 0 0 0 0 0 0 0 0 0 0 0 0 0 0 0 0 0 0 0 0 0 0 0 0 0 0 0 0 0 0 0 0 0 0 0 0 0 0 0 0 0 0 0 0 0 0 0 0 0 0 0 0 0 0 0 0 0 0 0 0 0 0 0 0 0 0 0 0 0 0 0 0 0 0 0 0 0 0 0 0 0 0 0 0 0 0 0 0 0 0 0 0 0 0 0 0 0 0 0 0 0 0 94 95 95 95 95 95 95 95 95 95 95 95 95 95 95 95 95 95 95 95 95 95 
0 0 0 0 0 0 0 0 0 0 0 0 0 0 0 0 0 0 0 0 0 0 0 0 0 0 0 0 0 0 0 0 0 0 0 0 0 0 0 0 0 0 0 0 0 0 0 0 0 0 0 0 0 0 0 0 0 0 0 0 0 0 0 0 0 0 0 0 0 0 0 0 0 0 0 0 0 0 0 0 0 0 0 0 0 0 0 0 0 470 470 470 0 0 0 0 0 0 0 0 0 0 0 0 0 0 0 0 0 0 0 0 0 0 0 0 0 0 0 0 0 0 0 0 0 0 0 0 0 0 0 0 0 0 0 0 0 0 0 0 0 0 0 0 0 0 0 0 0 0 0 0 0 0 94 95 95 95 95 95 95 95 95 95 95 95 95 95 95 95 95 95 95 95 95 95 
0 0 0 0 0 0 0 0 0 0 0 0 0 0 0 0 0 0 0 0 0 0 0 0 0 0 0 0 0 0 0 0 0 0 0 0 0 0 0 0 0 0 0 0 0 0 0 0 0 0 0 0 0 0 0 0 0 0 0 0 0 0 0 0 0 0 0 0 0 0 0 0 0 0 0 0 0 0 0 0 0 0 0 0 0 470 470 470 470 470 0 441 470 470 0 0 0 0 0 0 0 0 0 0 0 0 0 0 0 0 0 0 0 0 0 0 0 0 0 0 0 0 0 0 0 0 0 0 0 0 0 0 0 0 0 0 0 0 0 0 0 0 0 0 0 0 0 0 0 0 0 0 0 0 94 95 95 95 95 95 95 95 95 95 95 95 95 95 95 95 95 95 95 95 95 95 
0 0 0 0 0 0 0 0 0 0 0 0 0 0 0 0 0 0 0 0 0 0 0 0 0 0 0 0 0 0 0 0 0 0 0 0 0 0 0 0 0 0 0 0 0 0 0 0 0 0 0 0 0 0 0 0 0 0 0 0 0 0 0 0 0 0 0 0 0 0 0 0 0 0 0 0 0 0 0 0 0 0 0 0 470 470 470 470 470 0 0 0 0 470 470 0 470 470 470 470 470 470 470 470 470 470 0 0 0 0 0 0 0 0 0 0 0 0 0 0 0 0 0 0 0 0 0 0 0 0 0 0 0 0 0 0 0 0 0 0 0 0 0 0 0 0 0 0 0 0 0 0 0 0 94 95 95 95 95 95 95 95 95 95 95 95 95 95 95 95 95 95 95 95 95 95 
0 0 0 0 0 0 0 0 0 0 0 0 0 0 0 0 0 0 0 0 0 0 0 0 0 0 0 0 0 0 0 0 0 0 0 0 0 0 0 0 0 0 0 0 0 0 0 0 0 0 0 0 0 0 0 0 0 0 0 0 0 0 0 0 0 0 0 0 0 0 0 0 0 0 0 0 0 0 0 0 0 0 0 0 470 442 473 0 0 0 0 0 0 0 470 470 470 470 470 441 0 0 0 0 0 470 470 470 470 470 0 0 0 0 0 0 0 0 0 0 0 0 0 0 0 0 0 0 0 0 0 0 0 0 0 0 0 0 0 0 0 0 0 0 0 0 0 0 0 0 0 0 0 0 94 95 95 95 95 95 95 95 95 95 95 95 95 95 95 95 95 95 95 95 95 95 
0 0 0 0 0 0 0 0 0 0 0 0 0 0 0 0 0 0 0 0 0 0 0 0 0 0 0 0 0 0 0 0 0 0 0 0 470 470 0 0 0 0 0 0 0 0 0 0 0 0 0 0 0 0 0 0 0 0 0 0 0 0 0 0 0 0 0 0 0 0 0 0 0 0 0 0 0 0 0 0 0 0 0 0 0 0 0 0 0 0 0 0 0 0 0 470 470 0 0 0 0 0 0 0 0 0 0 0 0 470 470 470 470 0 0 0 0 0 0 0 0 0 0 0 0 0 0 0 0 0 0 0 0 0 0 0 0 0 0 0 0 470 470 470 0 0 0 0 0 0 0 0 0 0 94 95 95 95 95 95 95 95 95 95 95 95 95 95 95 95 95 95 95 95 95 95 
0 0 0 0 0 0 0 0 0 0 0 0 0 0 0 0 0 0 0 0 0 0 0 0 0 0 0 0 0 0 0 0 0 0 0 470 470 0 0 0 0 0 0 0 0 0 0 0 0 0 0 0 0 0 0 0 0 0 0 0 0 0 0 0 0 0 0 0 0 0 0 0 0 0 0 470 470 470 470 470 470 443 0 0 0 0 0 0 0 0 0 0 0 0 0 0 0 0 0 0 0 0 0 0 0 0 0 0 443 0 0 0 470 470 470 0 0 0 0 0 0 0 0 0 0 0 0 0 0 0 0 0 0 0 0 0 0 0 0 470 470 470 0 470 470 470 0 0 470 0 0 0 0 0 94 95 95 95 95 95 95 95 95 95 95 95 95 95 95 95 95 95 95 95 95 95 
0 0 0 0 0 0 0 0 0 0 0 0 0 0 0 0 0 0 0 0 0 0 0 0 470 0 0 0 0 0 0 0 0 0 470 470 0 0 0 0 0 0 0 0 0 0 0 0 0 0 0 0 0 0 0 471 471 0 470 470 470 0 0 0 0 0 0 470 470 470 470 470 470 470 470 470 0 0 0 0 0 0 0 0 0 0 0 0 0 0 0 0 0 0 0 0 0 0 0 0 0 0 0 0 0 0 0 0 0 0 0 0 0 0 470 0 0 0 0 0 0 0 0 0 0 0 0 0 0 0 0 0 0 0 0 0 0 0 470 470 0 0 0 0 0 470 470 470 470 0 0 0 0 0 94 95 95 95 95 95 95 95 95 95 95 95 95 95 95 95 95 95 95 95 95 95 
0 0 0 0 470 470 0 0 0 0 0 0 0 0 0 0 0 0 0 0 0 0 0 470 470 0 0 0 0 471 471 471 0 0 470 0 0 0 0 0 0 0 0 0 0 0 0 0 0 0 0 0 471 471 471 471 471 470 470 0 470 0 0 0 0 0 470 470 0 0 0 0 0 0 0 0 0 0 0 0 0 88 89 89 90 123 0 0 0 0 0 0 0 442 0 0 0 0 0 0 0 0 0 0 0 0 0 0 0 0 0 0 0 0 0 0 0 0 0 0 0 470 0 0 0 0 0 0 0 0 0 0 0 470 0 0 470 470 470 0 0 0 0 0 0 0 470 470 470 470 0 0 0 0 94 95 95 95 95 95 95 95 95 95 95 95 95 95 95 95 95 95 95 95 95 95 
0 0 471 470 470 470 0 0 0 0 471 471 471 471 471 471 471 471 0 0 0 0 470 470 470 0 0 471 471 471 0 0 0 0 470 0 0 0 0 0 0 0 0 0 0 470 470 470 0 0 471 471 471 471 471 471 470 470 470 470 0 0 0 0 0 0 470 0 0 0 0 0 0 0 0 0 0 0 0 0 0 146 147 147 148 152 0 0 0 0 0 0 0 0 0 0 0 0 0 0 0 0 0 0 0 0 0 0 0 0 0 0 0 0 0 0 0 0 0 0 0 470 470 0 0 0 0 0 0 0 0 0 0 470 0 0 470 0 0 0 0 0 0 0 0 470 470 0 0 470 470 470 0 0 94 95 95 95 95 95 95 95 95 95 95 95 95 95 95 95 95 95 95 95 95 95 
0 0 471 471 471 471 471 471 471 471 471 0 0 0 0 0 0 0 470 470 470 470 470 470 0 471 471 471 471 0 0 0 0 0 470 0 0 0 0 0 0 0 0 470 470 470 470 0 471 471 471 471 471 471 471 471 471 471 470 470 0 0 0 0 0 470 470 0 0 0 0 0 0 0 0 441 0 0 0 0 0 179 180 180 180 181 0 0 0 0 0 0 333 333 333 333 333 333 333 333 333 333 333 333 333 333 0 0 0 0 0 0 0 0 0 0 0 0 0 0 0 470 470 0 0 0 0 0 0 0 0 0 0 470 470 470 470 0 0 0 0 0 0 0 0 470 0 0 0 0 0 470 470 0 94 95 95 95 95 95 95 95 95 95 95 95 95 95 95 95 95 95 95 95 95 95 
0 0 0 470 471 0 0 0 470 470 470 470 470 470 470 470 470 470 470 0 0 0 0 471 471 0 0 471 0 0 0 0 0 0 471 0 0 0 0 0 0 0 470 470 470 470 471 471 470 471 471 471 470 471 471 470 470 470 470 470 470 470 0 0 0 470 0 0 0 0 0 0 0 0 0 0 0 0 0 0 0 0 0 0 0 0 0 333 333 333 333 0 0 0 0 0 0 0 0 0 0 0 0 0 0 0 0 0 0 0 0 0 0 0 0 0 0 0 0 0 470 470 0 0 0 0 0 0 0 0 0 0 470 470 470 470 0 0 0 0 0 0 0 0 0 470 470 0 0 0 0 470 0 0 94 95 95 95 95 95 95 95 95 95 95 95 95 95 95 95 95 95 95 95 95 95 
0 0 0 470 471 471 471 471 471 471 471 471 471 471 0 471 471 471 471 471 471 471 471 471 471 471 471 471 0 0 0 0 0 470 470 0 0 0 0 0 0 0 471 471 471 471 471 470 470 0 0 0 0 0 471 471 471 0 470 470 470 470 0 0 0 470 0 0 0 0 0 0 0 0 0 0 0 0 0 0 0 0 0 0 0 0 0 0 0 0 0 0 0 0 0 0 0 0 0 0 0 0 0 0 0 0 0 0 0 0 0 0 0 0 0 0 0 0 0 470 470 470 470 0 0 0 0 0 0 0 0 0 470 0 443 0 0 0 0 0 0 0 0 0 0 0 470 470 0 0 0 470 0 0 94 95 95 95 95 95 95 95 95 95 95 95 95 95 95 95 95 95 95 95 95 95 
0 0 0 470 470 0 471 471 471 471 471 471 471 471 471 471 471 471 0 0 0 0 0 0 0 0 471 0 0 0 0 0 0 470 0 0 0 0 0 471 471 471 470 470 0 0 0 0 0 0 0 0 0 0 0 0 471 471 0 0 0 0 0 0 0 471 471 0 0 0 0 0 0 0 0 0 0 0 0 0 0 0 0 0 0 0 0 0 0 0 0 0 0 0 0 0 0 0 0 0 0 0 0 0 0 0 0 0 0 0 0 0 0 0 0 0 0 470 470 470 470 0 470 470 441 0 0 0 0 0 0 470 470 0 0 0 0 0 0 0 0 0 0 0 0 0 0 470 470 0 0 470 0 0 94 95 95 95 95 95 95 95 95 95 95 95 95 95 95 95 95 95 95 95 95 95 
0 0 0 470 0 471 471 0 0 0 0 0 0 0 0 0 0 0 0 0 0 0 0 0 0 0 0 0 0 0 0 0 0 0 0 0 0 0 0 0 0 0 0 0 0 0 0 0 0 0 0 0 0 0 0 0 0 471 471 0 0 0 0 0 0 0 471 0 0 0 0 0 0 0 0 443 0 0 0 0 0 0 0 0 0 0 0 0 0 0 0 0 0 0 0 0 0 0 0 0 0 0 0 0 0 0 0 0 0 0 0 0 0 0 0 0 470 470 470 470 0 0 0 470 470 470 470 470 470 470 470 470 0 0 0 0 0 0 0 0 0 0 0 0 0 0 0 0 470 470 470 470 0 0 94 95 95 95 95 95 95 95 95 95 95 95 95 95 95 95 95 95 95 95 95 95 
0 0 0 0 0 0 0 0 0 0 0 0 0 0 0 0 0 0 0 0 331 332 0 0 0 0 0 0 0 471 0 0 0 0 0 0 0 0 443 0 0 0 0 0 0 0 0 0 0 0 0 0 0 471 0 0 0 0 0 471 471 0 0 0 0 0 0 0 0 0 0 0 0 0 0 0 0 0 0 0 0 0 0 0 0 0 0 0 0 0 0 0 0 0 0 0 0 0 0 0 0 0 0 0 0 0 0 0 0 0 0 0 0 0 0 470 470 0 0 0 0 0 0 0 0 0 0 0 470 470 470 0 0 0 0 0 0 0 0 0 0 0 0 0 0 0 0 0 442 0 0 0 0 0 94 95 95 95 95 95 95 95 95 95 95 95 95 95 95 95 95 95 95 95 95 95 
0 0 0 0 0 0 0 383 384 384 385 0 0 0 0 0 0 466 0 0 360 361 0 0 0 0 0 0 442 0 0 0 0 0 0 0 0 0 0 0 331 332 0 0 0 0 0 0 0 0 0 0 0 0 0 0 0 471 471 471 471 0 0 0 0 0 0 0 0 0 0 0 0 0 0 0 0 0 0 0 0 0 0 0 0 0 0 0 0 0 0 0 0 0 0 0 0 0 0 0 0 0 383 384 384 384 385 0 0 0 0 0 0 0 0 470 443 0 0 0 0 0 0 0 0 0 0 470 470 470 0 0 0 0 0 4 5 6 123 0 0 0 0 0 441 0 0 0 0 0 0 0 0 0 94 95 95 95 95 95 95 95 95 95 95 95 95 95 95 95 95 95 95 95 95 95 
0 441 0 0 0 0 0 412 413 413 414 0 0 0 441 0 0 0 0 0 0 0 0 0 0 0 0 0 0 0 0 0 0 0 0 0 0 0 0 0 360 361 0 0 0 0 0 0 0 0 0 0 0 442 0 0 0 0 0 0 0 0 0 0 0 0 0 0 0 0 0 0 0 0 331 332 0 0 0 0 0 0 0 0 0 0 0 0 0 0 0 0 0 0 0 0 0 0 0 0 0 0 412 413 413 413 414 0 0 0 0 0 0 0 0 0 0 0 0 0 0 0 0 0 0 0 0 470 470 0 0 0 0 0 0 33 34 35 152 0 0 0 0 0 0 0 0 0 0 9 10 0 0 0 94 95 95 95 95 95 95 95 95 95 95 95 95 95 95 95 95 95 95 95 95 95 
0 0 0 0 0 0 0 0 0 0 0 0 0 0 0 0 0 0 0 0 0 0 0 0 0 0 0 0 0 466 0 0 1 2 2 3 123 0 0 0 0 0 0 0 441 383 384 384 384 385 0 0 0 0 0 0 0 0 0 0 0 0 441 0 0 0 0 0 0 0 0 0 0 0 360 361 0 0 0 0 0 0 0 0 0 0 0 0 0 0 0 0 0 0 0 0 0 0 0 0 0 0 0 0 0 0 0 0 0 0 0 0 0 0 0 0 0 0 0 0 0 0 0 0 0 0 0 0 0 442 0 0 0 0 0 33 34 35 152 0 0 0 0 0 331 332 0 0 0 38 68 10 0 0 94 95 95 95 95 95 95 95 95 95 95 95 95 95 95 95 95 95 95 95 95 95 
0 0 0 0 0 0 0 0 0 442 0 466 0 0 0 0 0 0 0 0 0 0 0 0 0 0 0 0 0 0 0 0 30 31 31 32 152 0 0 0 0 0 0 0 0 412 413 413 413 414 0 0 0 0 0 0 0 0 0 0 0 0 0 0 0 0 0 0 0 0 0 0 0 0 0 0 0 0 0 0 0 0 91 92 92 92 92 92 93 123 0 0 0 0 0 0 0 0 0 0 0 0 0 0 0 0 0 0 0 0 0 0 0 0 0 0 0 0 0 0 0 0 0 0 0 0 0 0 0 0 0 0 0 0 0 33 34 35 152 0 0 0 0 0 360 361 0 0 0 38 96 39 0 0 94 95 95 95 95 95 95 7 8 95 95 95 95 95 95 95 95 95 95 95 95 95 
0 0 0 0 0 0 0 0 0 0 0 0 0 0 0 0 0 91 92 93 123 0 0 0 0 0 466 0 0 88 89 89 90 123 31 32 152 0 0 0 0 0 0 0 0 0 0 0 0 0 0 0 0 0 0 9 10 0 0 0 0 0 0 0 0 0 0 443 0 0 0 0 0 0 0 0 0 0 0 0 0 0 120 121 121 121 121 121 122 152 0 0 0 310 310 0 0 0 0 0 0 0 0 0 0 0 0 0 0 0 0 0 0 0 0 0 0 0 0 0 0 0 0 0 0 0 0 0 0 0 0 0 0 0 0 33 34 35 152 0 0 0 0 468 468 468 0 0 9 67 96 39 0 0 94 95 95 95 95 95 95 36 37 95 95 95 95 154 155 95 95 95 95 95 95 95 
0 0 9 10 0 0 0 0 0 0 0 0 0 0 0 0 0 120 121 122 152 0 0 0 0 0 0 0 0 117 118 118 119 152 31 32 152 0 0 0 0 0 0 0 0 0 0 0 0 0 0 0 9 10 9 67 39 9 10 0 9 10 124 124 0 0 0 0 0 0 0 0 0 0 0 0 0 0 0 0 88 89 89 89 89 89 90 123 122 152 0 0 0 0 0 0 0 0 0 0 0 0 0 0 0 0 0 0 0 0 0 0 0 0 0 0 0 0 0 0 0 0 0 0 0 0 0 0 0 0 0 0 0 0 0 33 34 35 152 0 0 0 0 0 0 0 0 9 67 96 96 39 0 0 94 95 95 95 95 95 95 36 7 8 95 95 95 183 184 95 95 95 95 95 95 95 
0 9 67 39 9 10 9 10 0 0 0 0 0 17 17 88 89 90 123 122 152 0 0 0 0 4 5 5 5 6 123 118 119 152 31 32 152 0 0 0 0 0 0 0 0 0 0 0 0 0 0 0 38 68 67 68 67 96 39 0 38 68 10 124 0 0 0 0 0 0 0 0 0 0 0 0 0 0 0 0 117 118 118 118 118 118 119 152 122 152 0 0 0 0 0 0 0 156 0 310 0 0 0 310 0 0 0 0 0 0 0 0 0 0 0 0 0 0 9 10 0 0 0 0 0 0 0 0 0 0 0 0 0 88 89 90 123 35 152 0 0 0 0 0 0 0 0 38 96 96 96 39 0 0 94 95 95 95 95 95 95 36 95 37 95 95 95 95 95 95 95 95 7 8 95 95 
0 38 68 67 96 39 38 68 10 0 0 0 0 17 17 117 118 119 152 122 152 0 0 0 0 33 34 34 34 35 152 118 4 5 5 5 5 6 123 0 0 0 362 362 362 362 362 362 0 0 0 9 67 96 96 96 96 96 39 9 67 96 39 0 0 362 362 0 0 0 0 0 0 0 0 0 0 0 4 5 5 5 5 5 6 123 119 152 122 152 0 0 0 0 0 0 0 156 310 310 0 0 0 310 310 0 0 0 0 0 0 0 0 0 0 0 0 0 38 68 10 0 0 0 0 0 0 0 0 0 0 0 0 117 118 119 152 35 152 0 0 0 0 0 0 0 0 38 96 96 96 68 10 0 94 95 95 95 95 95 95 36 95 7 8 95 95 95 95 95 95 95 36 37 95 95 
0 38 96 96 96 68 67 38 39 0 362 362 362 17 17 146 147 148 152 151 152 0 0 0 0 62 63 63 63 64 152 118 62 63 63 63 63 64 152 490 491 491 491 491 491 491 491 491 491 491 491 491 491 491 491 491 491 491 491 491 491 491 491 491 491 491 491 492 0 474 0 0 0 0 362 362 0 0 62 63 63 63 63 63 64 152 148 152 151 152 0 0 0 0 0 0 0 310 310 310 0 0 0 310 310 310 0 362 362 362 0 0 0 0 0 0 0 9 67 96 39 0 0 0 0 0 0 0 0 0 0 0 0 146 147 148 152 64 152 0 0 0 0 0 0 0 0 38 96 96 96 96 39 0 94 95 95 95 95 95 66 65 95 95 37 95 95 95 95 95 95 7 8 37 95 95 
391 392 392 392 392 392 392 392 392 392 392 392 392 392 392 392 392 392 392 392 392 392 392 392 392 392 392 392 392 392 392 392 392 392 392 392 392 392 393 519 520 520 520 520 520 520 520 520 520 520 520 520 520 520 520 520 520 520 520 520 520 520 520 520 520 520 520 521 0 0 474 474 391 392 392 392 392 392 392 392 392 392 392 392 392 392 392 392 392 392 392 392 393 474 474 391 392 392 392 393 474 474 474 391 392 392 392 392 392 392 392 392 392 392 392 392 392 392 392 392 392 392 392 392 392 392 392 392 392 392 392 392 392 392 392 392 392 392 393 208 391 392 392 392 392 392 392 392 392 392 392 392 392 392 392 392 392 392 392 392 392 392 392 392 392 392 392 392 392 392 392 392 392 392 392 393 
0 0 0 0 0 0 0 0 0 0 0 0 0 0 0 0 0 0 0 0 0 0 0 0 0 0 0 0 0 0 0 0 0 0 95 95 95 95 95 95 95 95 95 95 95 95 95 95 95 95 95 95 95 95 95 95 95 95 95 95 95 95 95 95 95 95 95 95 95 95 95 95 95 95 95 95 95 95 95 95 95 95 95 95 95 95 95 95 95 95 95 95 95 95 95 95 95 95 95 95 95 95 95 95 95 95 95 95 95 95 95 95 95 95 95 95 95 95 95 95 95 95 95 95 95 95 95 95 95 95 95 95 95 95 95 95 95 95 95 95 95 95 95 95 95 95 95 95 95 95 95 95 95 95 95 95 95 95 95 95 95 95 95 95 95 95 95 95 95 95 95 95 95 95 95 95 
0 0 0 0 0 0 0 0 0 0 0 0 0 0 0 0 0 0 0 0 0 0 0 0 0 0 0 0 0 0 0 0 0 0 95 95 95 95 95 95 95 95 95 95 95 95 95 95 95 95 95 95 95 95 95 95 95 95 95 95 95 95 95 95 95 95 95 95 95 95 95 95 95 95 95 95 95 95 95 95 95 95 95 95 95 95 95 95 95 95 95 95 95 95 95 95 95 95 95 95 95 95 95 95 95 95 95 95 95 95 95 95 95 95 95 95 95 95 95 95 95 95 95 95 95 95 95 95 95 95 95 95 95 95 95 95 95 95 95 95 95 95 95 95 95 95 95 95 95 95 95 95 95 95 95 95 95 95 95 95 95 95 95 95 95 95 95 95 95 95 95 95 95 95 95 95 
0 0 0 0 0 0 0 0 0 0 0 0 0 0 0 0 0 0 0 0 0 0 0 0 0 0 0 0 0 0 0 0 0 0 95 95 95 95 95 95 95 95 95 95 95 95 95 95 95 95 95 95 95 95 95 95 95 95 95 95 95 95 95 95 95 95 95 95 95 95 95 95 95 95 95 95 95 95 95 95 95 95 95 95 95 95 95 95 95 95 95 95 95 95 95 95 95 95 95 95 95 95 95 95 95 95 95 95 95 95 95 95 95 95 95 95 95 95 95 95 95 95 337 337 337 337 337 337 337 337 0 0 337 337 337 337 337 337 337 337 337 337 337 337 0 0 337 337 337 337 337 337 337 337 95 95 95 95 95 95 95 95 95 95 95 95 95 95 95 95 95 95 95 95 95 95 
0 0 0 0 0 0 0 0 0 0 0 0 0 0 0 0 0 0 0 0 0 0 0 0 0 0 0 0 0 0 0 0 0 0 95 95 95 95 95 95 95 95 95 95 95 95 95 95 95 95 95 95 95 95 95 95 95 95 95 95 95 95 95 95 95 95 95 95 95 95 95 95 95 95 95 95 95 95 95 95 95 95 95 95 95 95 95 95 95 95 95 95 95 95 95 95 95 95 95 95 95 95 95 95 95 95 95 95 95 95 95 95 95 95 95 95 95 95 95 95 95 95 337 337 337 337 337 337 337 337 0 0 95 95 95 95 95 95 95 95 95 95 95 95 0 0 337 337 337 337 337 337 337 337 95 95 95 95 95 95 95 95 95 95 95 95 95 95 95 95 95 95 95 95 95 95 
0 0 0 0 0 0 0 0 0 0 0 0 0 0 0 0 0 0 0 0 0 0 0 0 0 0 0 0 0 0 0 0 0 0 95 95 95 95 95 95 95 95 95 95 95 95 95 95 95 95 95 95 95 95 95 95 95 95 95 95 95 95 95 95 95 95 95 95 95 95 95 95 95 95 95 95 95 95 95 95 95 95 95 95 95 95 95 95 95 95 95 95 95 95 95 95 95 95 95 95 95 95 95 95 95 95 95 95 95 95 95 95 95 95 95 95 95 95 95 95 95 95 337 337 337 337 337 337 337 337 95 95 95 95 95 95 95 95 95 95 95 95 95 95 95 95 337 337 337 337 337 337 337 337 95 95 95 95 95 95 95 95 95 95 95 95 95 95 95 95 95 95 95 95 95 95 
0 0 0 0 0 0 0 0 0 0 0 0 0 0 0 0 0 0 0 0 0 0 0 0 0 0 0 0 0 0 0 0 0 0 95 95 95 95 95 95 95 95 95 95 95 95 95 95 95 95 95 95 95 95 95 95 95 95 95 95 95 95 95 95 95 95 95 95 95 95 95 95 95 95 95 95 95 95 95 95 95 95 95 95 95 95 95 95 95 95 95 95 95 95 95 95 95 95 95 95 95 95 95 95 95 95 95 95 95 95 95 95 95 95 95 95 95 95 95 95 95 95 337 337 337 337 337 337 337 337 95 95 95 95 95 95 95 95 95 95 95 95 95 95 95 95 337 337 337 337 337 337 337 337 95 95 95 95 95 95 95 95 95 95 95 95 95 95 95 95 95 95 95 95 95 95 
0 0 0 0 0 0 0 0 0 0 0 0 0 0 0 0 0 0 0 0 0 0 0 0 0 0 0 0 0 0 0 0 0 0 95 95 95 95 95 95 95 95 95 95 95 95 95 95 95 95 95 95 95 95 95 95 95 95 95 95 95 95 95 95 95 95 95 95 95 95 95 95 95 95 95 95 95 95 95 95 95 95 95 95 95 95 95 95 95 95 95 95 95 95 95 95 95 95 95 95 95 95 95 95 95 95 95 95 95 95 95 95 95 95 95 95 95 95 95 95 95 95 337 337 337 337 337 337 337 337 95 95 95 95 95 95 95 95 95 95 95 95 95 337 337 337 337 337 337 337 337 337 337 337 95 95 95 95 95 95 95 95 95 95 95 95 95 95 95 95 95 95 95 95 95 95 
0 0 0 0 0 0 0 0 0 0 0 0 0 0 0 0 0 0 0 0 0 0 0 0 0 0 0 0 0 0 0 0 0 0 95 95 95 95 95 95 95 95 95 95 95 95 95 95 95 95 95 95 95 95 95 95 95 95 95 95 95 95 95 95 95 95 95 95 95 95 95 95 95 95 95 95 95 95 95 95 95 95 95 95 95 95 95 95 95 95 95 95 95 95 95 95 95 95 95 95 95 95 95 95 95 95 95 95 95 95 95 95 95 95 95 95 95 95 95 95 95 95 337 337 337 337 337 337 337 337 95 95 95 95 95 95 95 95 95 95 95 95 337 337 337 337 337 337 337 337 337 337 337 337 95 95 95 95 95 95 95 95 95 95 95 95 95 95 95 95 95 95 95 95 95 95 
0 0 0 0 0 0 0 0 0 0 0 0 0 0 0 0 0 0 0 0 0 0 0 0 0 0 0 0 0 0 0 0 0 0 95 95 95 95 95 95 95 95 95 95 95 95 95 95 95 95 95 95 95 95 95 95 95 95 95 95 95 95 95 95 95 95 95 95 95 95 95 95 95 95 95 95 95 95 95 95 95 95 95 95 95 95 95 95 95 95 95 95 95 95 95 95 95 95 95 95 95 95 95 95 95 95 95 95 95 95 95 95 95 95 95 95 95 95 95 95 95 95 337 337 337 337 337 337 337 337 95 95 95 95 95 95 95 95 95 95 95 337 337 337 337 337 337 337 337 337 337 337 337 337 95 95 95 95 95 95 95 95 95 95 95 95 95 95 95 95 95 95 95 95 95 95 
0 0 0 0 0 0 0 0 0 0 0 0 0 0 0 0 0 0 0 0 0 0 0 0 0 0 0 0 0 0 0 0 0 0 95 95 95 95 95 95 95 95 95 95 95 95 95 95 95 95 95 95 95 95 95 95 95 95 95 95 95 95 95 95 95 95 95 95 95 95 95 95 95 95 95 95 95 95 95 95 95 95 95 95 95 95 95 95 95 95 95 95 95 95 95 95 95 95 95 95 95 95 95 95 95 95 95 95 95 95 95 95 95 95 95 95 95 95 95 95 95 95 337 337 337 337 337 337 337 337 95 95 95 95 95 95 95 95 95 95 337 337 337 337 337 337 337 337 337 337 337 337 337 337 95 95 95 95 95 95 95 95 95 95 95 95 95 95 95 95 95 95 95 95 95 95 
0 0 0 0 0 0 0 0 0 0 0 0 0 0 0 0 0 0 0 0 0 0 0 0 0 0 466 466 0 0 0 0 0 0 95 95 95 95 95 95 95 95 95 95 95 95 95 95 95 95 95 95 95 95 95 95 95 95 95 95 95 95 95 95 95 95 95 95 95 95 95 95 95 95 95 95 95 95 95 95 95 95 95 95 95 95 95 95 95 95 95 95 95 95 95 95 95 95 95 95 95 95 95 95 95 95 95 95 95 95 95 95 95 95 95 95 95 95 95 95 95 95 337 337 337 337 337 337 337 337 95 95 95 95 95 95 95 95 95 337 337 337 337 337 337 337 337 337 337 337 337 337 337 337 95 95 95 95 95 95 95 95 95 95 95 95 95 95 95 95 95 95 95 95 95 95 
0 0 0 0 0 0 0 0 0 0 0 0 0 0 0 0 0 0 0 0 0 0 0 0 0 0 0 0 0 0 0 0 0 0 95 95 95 95 95 95 95 95 95 95 95 95 95 95 95 95 95 95 95 95 95 95 95 95 95 95 95 95 95 95 95 95 95 95 95 95 95 95 95 95 95 95 95 95 95 95 95 95 95 95 95 95 95 95 95 95 95 95 95 95 95 95 95 95 95 95 95 95 95 95 95 95 95 95 95 95 95 95 95 95 95 95 95 95 95 95 95 95 337 337 337 337 337 337 337 337 95 95 95 95 95 95 95 95 337 337 337 337 337 337 337 337 337 337 337 337 337 337 337 337 95 95 95 95 95 95 95 95 95 95 95 95 95 95 95 95 95 95 95 95 95 95 
0 0 0 0 0 0 0 0 0 0 0 0 0 0 0 0 0 0 0 0 0 0 0 0 0 0 0 0 0 0 0 0 0 0 95 95 95 95 95 95 95 95 95 95 95 95 95 95 95 95 95 95 95 95 95 95 95 95 95 95 95 95 95 95 95 95 95 95 95 95 95 95 95 95 95 95 95 95 95 95 95 95 95 95 95 95 95 95 95 95 95 95 95 95 95 95 95 95 95 95 95 95 95 95 95 95 95 95 95 95 95 95 95 95 95 95 95 95 95 95 95 95 337 337 337 337 337 337 337 337 337 337 337 337 337 337 337 337 337 337 337 337 337 337 337 337 337 337 337 337 337 337 337 337 95 95 95 95 95 95 95 95 95 95 95 95 95 95 95 95 95 95 95 95 95 95 
0 0 0 0 0 0 0 0 0 0 0 0 0 0 0 0 0 0 0 0 0 0 0 0 0 0 0 0 0 0 0 0 0 0 95 95 95 95 95 95 95 95 95 95 95 95 95 95 95 95 95 95 95 95 95 95 95 95 95 95 95 95 95 95 95 95 95 95 95 95 95 95 95 95 95 95 95 95 95 95 95 95 95 95 95 95 95 95 95 95 95 95 95 95 95 95 95 95 95 95 95 95 95 95 95 95 95 95 95 95 95 95 95 95 95 95 95 95 95 95 95 95 337 337 337 337 337 337 337 337 337 337 337 337 337 337 337 337 337 337 337 337 337 337 337 337 337 337 337 337 337 337 337 337 95 95 95 95 95 95 95 95 95 95 95 95 95 95 95 95 95 95 95 95 95 95